15:15
0:3:0:2:0:0:3:0:0:2:0:2:0:2:0
1:0:0:0:0:0:0:0:0:0:0:0:1:0:1
0:4:0:2:0:1:0:2:0:5:0:3:0:1:0
0:0:2:0:3:0:5:0:2:0:0:0:5:0:4
2:0:0:2:0:3:0:0:0:0:1:0:0:2:0
0:0:4:0:3:0:0:1:0:2:0:0:2:0:2
2:0:0:0:0:0:2:0:2:0:3:0:0:3:0
0:0:2:0:0:2:0:2:0:0:0:0:2:0:2
2:0:0:0:3:0:1:0:0:2:0:0:0:3:0
0:1:0:0:0:0:0:0:1:0:3:0:4:0:2
3:0:5:0:7:0:0:6:0:5:0:0:0:4:0
0:1:0:0:0:0:0:0:1:0:4:0:5:0:2
0:0:2:0:5:0:1:0:0:2:0:0:0:4:0
1:0:0:0:0:1:0:2:0:0:3:0:2:0:1
0:2:0:0:3:0:2:0:3:0:0:3:0:4:0