10:7
4:0:4:0:0:2:0:0:1:0
0:0:0:0:3:0:0:3:0:3
3:0:2:0:0:0:2:0:1:0
0:0:0:0:0:0:0:3:0:3
4:0:3:0:3:0:3:0:1:0
0:0:0:0:0:0:0:2:0:1
3:0:2:0:3:0:5:0:2:0
