15:15
0:2:0:0:0:3:0:0:2:0:0:0:2:0:2
2:0:0:1:0:0:0:2:0:0:1:0:0:0:0
0:3:0:0:0:3:0:0:0:2:0:4:0:1:0
3:0:0:0:0:0:0:2:0:0:0:0:1:0:3
0:3:0:4:0:2:0:0:0:0:0:3:0:2:0
2:0:1:0:3:0:0:4:0:1:0:0:1:0:0
0:1:0:2:0:0:0:0:0:0:0:2:0:0:2
0:0:0:0:4:0:0:8:0:4:0:0:0:1:0
3:0:2:0:0:0:0:0:0:0:0:0:2:0:3
0:2:0:4:0:2:0:5:0:5:0:6:0:1:0
3:0:1:0:2:0:4:0:2:0:1:0:0:0:0
0:1:0:2:0:1:0:1:0:2:0:5:0:0:3
4:0:2:0:1:0:4:0:4:0:2:0:0:2:0
0:1:0:3:0:2:0:0:0:0:0:0:0:0:1
3:0:3:0:3:0:3:0:2:0:0:3:0:3:0